R					640 480
NO srcs/pictures/bluestone.png
SO srcs/pictures/eagle.png
WE srcs/pictures/gomer.png
EA srcs/pictures/wood.png
S srcs/pictures/barrel .png
F 174, 130, 185
C 174, 130, 185
        1111111111111111111111111
        1000000000110000000000001
        1011000001110000000000001
        1001000000000000000000001
111111110011000001110000000000001
100000000011000001110111100011111
11100000000000000202000000000111
11100000000000000202000000000111
11100000000000000202000000000111
11100000000000000202000000000111
11100000000000000202000000000111
111000000000000002020000000000111
11100000000000000202000000000111
11100000000000000000000000000111
111000000000000000N0000000000111
11100000000000000000000000000111
11100000000001111100000000000111
11100000000000000000000000000111
11100000000000000000000000000111
11100000000000000000000010000111
11100000000000000000000000000111
11110111111111011101010010001111
11000000110101011100111111111111
10000000000000001101111111111111
10000000000000001101110000000111
11000001110101011111110000001111
11110111011101010101110000000111
11111111111111111111111110111111
11111111111111111111111111111111