	S		/Users/rvena/Desktop/cub3d/barrel .png
NO	/Users/rvena/Desktop/cub3d/bluestone.png
SO	/Users/rvena/Desktop/cub3d/bluestone.png
WE	b.png
EA	/Users/rvena/Desktop/cub3d/bluestone.png
											
R 			1920 1020
F  255   , 255, 255
C  255   , 255, 255



                                       
        111111111111111111111111111
        1000000000110000000000001
        1011000001110000002000001
        1001000000000000000000001
1111111110110000011100000000000W1
10000000001100000111011110001111111
11110111111111011100000010001111111
11110111111111011101010010001
11000000110101011100000010001
10002000000000001100000010001
10000000000000001101010010001
1100000111010101111101111000111
11110111 1110101 101111010001
11111111 1111111 111111111111