	S		/Users/rvena/Desktop/cub3d/barrel .png


NO	/Users/rvena/Desktop/cub3d/bluestone.png

SO /Users/rvena/Desktop/cub3d/eagle.png

WE	/Users/rvena/Desktop/cub3d/gomer.png

EA	/Users/rvena/Downloads/pics/wood.png

	
R 			640 420
	F  255   , 255, 255
	C  0   , 230, 0


        111111111111111111111111
        1000000000110000000000001
        1011000001110000002000001
        1001000000000000000000001
111111111011000001110000000000001
10000000001100000111011110001111111
111011111111101110000001000111111
1110111111111011101010010S01
10000001101010111000000100011
1000200000000000110000001001
10000000000000001101010010001
111000111010101111101111000111
11111111 1111111 111111111111